{
  "grid": [
    ["W", "W", "W", "W", "W", "W", "W", "W", "W", "W", "W", "W"],
    ["W", "P", "W", "W", "P", "P", "P", "P", "W", "W", "P", "W"],
    ["W", "W", "W", "P", "G", "W", "P", "G", "W", "P", "W", "W"],
    ["W", "P", "W", "W", "P", "W", "W", "P", "W", "P", "P", "W"],
    ["W", "W", "W", "P", "P", "W", "P", "P", "W", "P", "W", "W"],
    ["W", "P", "W", "W", "P", "W", "W", "P", "W", "P", "W", "W"],
    ["W", "W", "W", "P", "G", "W", "P", "G", "W", "P", "W", "W"],
    ["W", "P", "W", "W", "P", "W", "W", "P", "W", "P", "P", "W"],
    ["W", "W", "W", "P", "P", "W", "P", "P", "W", "P", "W", "W"],
    ["W", "P", "P", "P", "P", "P", "P", "P", "P", "P", "O", "W"],
    ["W", "W", "W", "W", "W", "W", "W", "W", "W", "W", "W", "W"],
    ["W", "W", "W", "W", "W", "W", "W", "W", "W", "W", "W", "W"]
  ],
  "start": { "x": 1, "y": 10 }
}