{
  "grid": [
    ["W", "W", "W", "W", "W", "W", "W", "W", "W", "W", "W", "W"],
    ["W", "P", "P", "P", "G", "P", "G", "P", "P", "P", "O", "W"],
    ["W", "P", "W", "W", "P", "W", "P", "W", "W", "P", "W", "W"],
    ["W", "P", "W", "W", "P", "W", "P", "W", "W", "P", "W", "W"],
    ["W", "P", "W", "W", "P", "W", "P", "W", "W", "P", "W", "W"],
    ["W", "P", "W", "W", "P", "W", "P", "W", "W", "P", "W", "W"],
    ["W", "P", "P", "P", "G", "P", "G", "P", "P", "P", "W", "W"],
    ["W", "P", "W", "W", "P", "W", "P", "W", "W", "P", "W", "W"],
    ["W", "P", "W", "W", "L", "W", "P", "W", "W", "P", "W", "W"],
    ["W", "P", "P", "P", "P", "P", "P", "P", "P", "P", "W", "W"],
    ["W", "W", "W", "W", "W", "W", "W", "W", "W", "W", "W", "W"],
    ["W", "W", "W", "W", "W", "W", "W", "W", "W", "W", "W", "W"]
  ],
  "start": { "x": 1, "y": 10 }
}