{
  "grid": [
    ["W", "W", "W", "W", "W", "W", "W", "W", "W", "W", "W", "W"],
    ["W", "P", "P", "P", "P", "P", "P", "P", "P", "P", "O", "W"],
    ["W", "P", "P", "P", "W", "G", "W", "P", "P", "P", "P", "W"],
    ["W", "P", "P", "W", "P", "P", "P", "W", "P", "P", "P", "W"],
    ["W", "P", "P", "W", "P", "P", "L", "W", "P", "P", "P", "W"],
    ["W", "P", "P", "G", "P", "P", "P", "G", "P", "P", "P", "W"],
    ["W", "P", "L", "W", "P", "P", "P", "W", "L", "P", "P", "W"],
    ["W", "P", "P", "W", "P", "P", "P", "W", "P", "P", "P", "W"],
    ["W", "P", "P", "P", "W", "G", "W", "P", "P", "P", "P", "W"],
    ["W", "P", "P", "P", "P", "L", "P", "P", "P", "P", "P", "W"],
    ["W", "P", "P", "P", "P", "P", "P", "P", "P", "P", "P", "W"],
    ["W", "W", "W", "W", "W", "W", "W", "W", "W", "W", "W", "W"]
  ],
  "start": { "x": 1, "y": 10 }
}