{
  "grid": [
    ["W", "W", "W", "W", "W", "W", "W", "W", "W", "W", "W", "W"],
    ["W", "P", "W", "W", "W", "W", "W", "W", "W", "P", "O", "W"],
    ["W", "P", "W", "P", "G", "P", "G", "P", "W", "P", "P", "W"],
    ["W", "P", "W", "P", "P", "P", "P", "P", "W", "P", "P", "W"],
    ["W", "P", "W", "P", "P", "P", "P", "P", "W", "P", "P", "W"],
    ["W", "P", "W", "P", "P", "P", "P", "P", "W", "P", "P", "W"],
    ["W", "P", "W", "P", "G", "P", "G", "P", "W", "P", "P", "W"],
    ["W", "P", "W", "W", "W", "W", "W", "W", "W", "P", "P", "W"],
    ["W", "P", "P", "P", "L", "P", "P", "P", "P", "P", "W", "W"],
    ["W", "P", "P", "P", "P", "P", "P", "P", "P", "P", "W", "W"],
    ["W", "W", "W", "W", "W", "W", "W", "W", "W", "W", "W", "W"],
    ["W", "W", "W", "W", "W", "W", "W", "W", "W", "W", "W", "W"]
  ],
  "start": { "x": 1, "y": 10 }
}