{
  "grid": [
    ["W", "W", "W", "W", "W", "W", "W", "W", "W", "W", "W", "W"],
    ["W", "P", "W", "W", "W", "W", "W", "P", "P", "P", "O", "W"],
    ["W", "P", "P", "P", "G", "P", "W", "P", "P", "P", "P", "W"],
    ["W", "P", "P", "P", "P", "P", "W", "P", "P", "P", "P", "W"],
    ["W", "P", "P", "P", "P", "P", "W", "P", "P", "P", "P", "W"],
    ["W", "P", "P", "P", "G", "P", "W", "P", "P", "P", "P", "W"],
    ["W", "P", "W", "W", "W", "W", "W", "P", "P", "P", "P", "W"],
    ["W", "P", "P", "P", "L", "P", "P", "P", "P", "P", "W", "W"],
    ["W", "P", "P", "P", "P", "P", "P", "P", "P", "P", "W", "W"],
    ["W", "P", "P", "P", "P", "P", "P", "P", "P", "P", "W", "W"],
    ["W", "W", "W", "W", "W", "W", "W", "W", "W", "W", "W", "W"],
    ["W", "W", "W", "W", "W", "W", "W", "W", "W", "W", "W", "W"]
  ],
  "start": { "x": 1, "y": 10 }
}