{
  "grid": [
    ["W", "W", "W", "W", "W", "W", "W", "W", "W", "W", "W", "W"],
    ["W", "T", "P", "P", "P", "P", "P", "P", "P", "P", "O", "W"],
    ["W", "P", "W", "W", "W", "W", "P", "P", "P", "P", "P", "W"],
    ["W", "P", "G", "P", "P", "P", "W", "P", "L", "L", "P", "W"],
    ["W", "P", "W", "P", "P", "P", "W", "L", "L", "L", "L", "W"],
    ["W", "P", "W", "P", "G", "P", "W", "G", "L", "L", "L", "W"],
    ["W", "P", "W", "P", "P", "P", "W", "P", "L", "L", "L", "W"],
    ["W", "P", "W", "P", "P", "P", "W", "P", "L", "L", "L", "W"],
    ["W", "P", "G", "P", "P", "P", "W", "P", "L", "L", "L", "W"],
    ["W", "P", "W", "W", "W", "W", "P", "P", "T", "L", "L", "W"],
    ["W", "P", "P", "P", "P", "P", "P", "P", "P", "P", "P", "W"],
    ["W", "W", "W", "W", "W", "W", "W", "W", "W", "W", "W", "W"]
  ],
  "start": { "x": 1, "y": 10 }
}