{
  "grid": [
    ["W", "W", "W", "W", "W", "W", "W", "W", "W", "W", "W", "W"],
    ["W", "P", "P", "P", "P", "P", "P", "P", "P", "W", "E", "W"],
    ["W", "P", "P", "P", "W", "W", "W", "W", "P", "W", "T", "W"],
    ["W", "P", "P", "W", "G", "P", "P", "P", "P", "W", "P", "W"],
    ["W", "P", "P", "W", "P", "P", "P", "P", "P", "W", "P", "W"],
    ["W", "P", "P", "W", "W", "W", "W", "G", "P", "P", "P", "W"],
    ["W", "P", "P", "W", "G", "P", "P", "P", "P", "P", "P", "W"],
    ["W", "P", "P", "W", "P", "P", "P", "P", "P", "P", "P", "W"],
    ["W", "P", "P", "G", "W", "W", "W", "W", "P", "P", "P", "W"],
    ["W", "P", "L", "L", "L", "T", "P", "P", "P", "P", "P", "W"],
    ["W", "P", "P", "P", "P", "P", "P", "P", "P", "P", "P", "W"],
    ["W", "W", "W", "W", "W", "W", "W", "W", "W", "W", "W", "W"]
  ],
  "start": { "x": 1, "y": 10 }
}