{
  "grid": [
    ["W", "W", "W", "W", "W", "W", "W", "W", "W", "W", "W", "W"],
    ["W", "P", "P", "P", "G", "P", "P", "P", "P", "W", "E", "W"],
    ["W", "P", "P", "P", "P", "W", "W", "P", "P", "W", "T", "W"],
    ["W", "P", "P", "P", "P", "W", "W", "P", "P", "W", "P", "W"],
    ["W", "P", "P", "P", "P", "W", "W", "P", "P", "W", "P", "W"],
    ["W", "T", "P", "P", "P", "W", "W", "P", "P", "P", "P", "W"],
    ["W", "P", "P", "P", "P", "W", "W", "G", "P", "P", "P", "W"],
    ["W", "P", "P", "P", "P", "G", "P", "P", "P", "P", "P", "W"],
    ["W", "P", "P", "G", "P", "W", "W", "P", "P", "P", "P", "W"],
    ["W", "P", "L", "L", "L", "W", "W", "P", "P", "P", "P", "W"],
    ["W", "P", "P", "P", "P", "P", "P", "P", "P", "P", "P", "W"],
    ["W", "W", "W", "W", "W", "W", "W", "W", "W", "W", "W", "W"]
  ],
  "start": { "x": 1, "y": 10 }
}
